#####
#   #
# $ # ###
# $ # #*#
### ###.#
 ## @  .#
 #   #  #
 #   ####
 #####